11111111111111111111
10000C0000000000C001
10P00000000000E00001
10000C0000000000C001
100000000C0000000001
10000000001000010001
1000010000C000011C01
10000000000000001111
1000000C000000000001
11111111111111111111