11111111111111111111
100000000P0000000001
100C0000C0C00E000001
11111111111111111111