11111111111111111111
10000C00000000000001
1000000000000E000001
10000C000P0000000001
100000000000000C0001
10000000001000000001
1000010000C000000001
10000000000000000001
1000000C000000000001
11111111111111111111