11111111111111111111
1000000C10001000C001
10P00111100000E00001
10000C00000001000101
10000X00001000001101
1000100001C000011C01
100111100000010C1111
11111111111111111111